                      ####              
                    ###..###############
            #####   #....... ..  ......#
#######  ####...##  #.....#. .##########
#.....#  #.......#  ##..#### ##         
#.....#  #. #....#   ####  # #          
#.....#  ## #...######  #### #          
#.....##### ### ###..#  #....#          
#.....      ###......####....#          
##########..##.......    ....#          
         #####....#######....#          
             ######     ######          