################
#.........#....#
#.........#....#
#....##...#....#
#....#....####.#
#...##.........#
#..............#
#.........##...#
#..#......##...#
#..............#
#..............#
################